11111111111111111
10E0000C0001100P1
10000100C00C10001
1C011100000000001
11111111111111111
