1111111111
10E00PCCC1
10000B00E1
1111111111

