111111111111111
100E0001100C001
10C0B0001000C01
1011110P0010001
100C00B00010E01
111111111111111
