11111111111111111
11100C01110000111
100P000000B000001
10000000C000C0001
11000000E00000011
11100C00000B00111
11111000C00011111
11111110001111111
11111111011111111
11111111111111111
