1111111111
10E000CCC1
1000P000E1
1111111111
